GGGGWGGVG
GVGGWGGGD
GGDGWGGDG
WWWWWWWVW
WWWDGWWWW
WVWWWWWWV
GGGGWDGGG
VDGGWGVGD
GGGVWGDGG
#
VVBBVBBVV
VBBBVBOOV
BYBBVBFOB
VVVVVVVVV
VVVTUVVVV
VVVVVVVVV
BBBBVBBBB
VBBBVBBBV
VVPPVBBVV
